-----------------------------Human body-----------------------------
Human body  - Тело человека
Head        - Голова
Neck        - Шея
Hand        - Рука, Кисть
Leg         - Нога от бедра до ступни
Hair        - Волосы
Shoulder    - Плечо
Arm         - Рука от кисти до плеча
Finger      - Палец
Foot (Feet) - Нога, Ступня
Waist       - Талия
Knee        - Колено
Toe         - Палец ноги
Elbow       - Локоть
Wrist       - Запястье
Thumb       - Большой палец руки
Ankle       - Лодыжка
------------------------------Face----------------------------------
Face          - Лицо
Ear           - Ухо
Forehead      - Лоб
Tooth (Teeth) - Зуб 
Cheek         - Щека
Lip           - Губа
Eye           - Глаз
Eyebrow       - Бровь
Nose          - Нос
Eyelash       - Ресница
Mouth         - Рот
Chin          - Подбородок
----------------------------Things----------------------------------
Things        - Вещи, Предметы
Room          - Комната
Book          - Книга
Page          - Страница
Pen           - Ручка
Desk          - Письменный рабочий стол
Lamp          - Лампа
Light         - Свет
Cup           - Чашка
Money         - Деньги


-----------------------------Handshake------------------------------
Germ           - Микроб
Fist           - Кулак 
Graduation     - Окончание учебного заведения
Greet          - Здороваться	
Hug            - Объятие
Loosely        - Плохо закреплено, Свободно
Ridiculous     - Нелепо, Глупо
Shake hands    - Пожать руки
Sleeve         - Рукав
Weapon         - Оружие
Keep fit phr   - Поддерживать физическую форму 
Mental health  - Душевное здоровье
Trend          - Тенденция, Тренд
Disease        - Болезнь, Заболевние
Cancer         - Рак
Exist          - Существовать
Illness        - Болезнь, Заболевние
Avoid          - Избегать, Уклоняться
Junk food      - Вредная еда
Plenty (of)    - Много
Weight-lifting - Тяжелая атлетика
Occasionally   - Время от времени, Иногда
Reduce         - Уменьшать, Сокращать
Crawl          - Ползать
Hurt           - Болеть, Повредить

Tom's present is big and expensive because his friends are _ (generous)(щедрый)



